{
    "keyboard": "splitkb/halcyon/kyria/rev4",
    "keymap": "BinaryApe",
    "layout": "LAYOUT_split_3x6_5_hlc",
    "layers": [
        [
            "KC_GRV",
            "KC_Q",
            "KC_W",
            "KC_F",
            "KC_P",
            "KC_B",
            "KC_J",
            "KC_L",
            "KC_U",
            "KC_Y",
            "KC_SCLN",
            "KC_MINUS",
            "MT(MOD_LCTL, KC_ESC)",
            "KC_A",
            "KC_R",
            "KC_S",
            "KC_T",
            "KC_G",
            "KC_M",
            "KC_N",
            "KC_E",
            "KC_I",
            "KC_O",
            "MT(MOD_RCTL, KC_QUOTE)",
            "KC_TAB",
            "KC_Z",
            "KC_X",
            "KC_C",
            "KC_D",
            "KC_V",
            "KC_ESC",
            "KC_CAPS",
            "KC_CAPS",
            "KC_ESC",
            "KC_K",
            "KC_H",
            "KC_COMM",
            "KC_DOT",
            "KC_SLSH",
            "KC_BSLS",
            "KC_TAB",
            "KC_LALT",
            "KC_LCTL",
            "KC_LSFT",
            "LT(NUMPAD, KC_BSPC)",
            "LT(NAVIGATION, KC_ENT)",
            "KC_SPC",
            "KC_TAB",
            "KC_RGUI",
            "KC_APP",
            "KC_MUTE",
            "KC_MUTE",
            "KC_MUTE",
            "KC_MUTE",
            "KC_MUTE",
            "KC_MUTE",
            "KC_MUTE",
            "KC_MUTE",
            "KC_MUTE",
            "KC_MUTE"
        ],
        [
            "KC_TRNS",
            "KC_TRNS",
            "KC_TRNS",
            "KC_TRNS",
            "KC_TRNS",
            "KC_TRNS",
            "KC_PGUP",
            "KC_HOME",
            "KC_UP",
            "KC_END",
            "KC_VOLU",
            "KC_DEL",
            "KC_TRNS",
            "KC_LGUI",
            "KC_LALT",
            "KC_LCTL",
            "KC_LSFT",
            "KC_TRNS",
            "KC_PGDN",
            "KC_LEFT",
            "KC_DOWN",
            "KC_RGHT",
            "KC_VOLD",
            "KC_INS",
            "KC_TRNS",
            "KC_TRNS",
            "KC_TRNS",
            "KC_TRNS",
            "KC_TRNS",
            "KC_TRNS",
            "KC_TRNS",
            "KC_SCRL",
            "KC_TRNS",
            "KC_TRNS",
            "KC_PAUSE",
            "KC_MPRV",
            "KC_MPLY",
            "KC_MNXT",
            "KC_MUTE",
            "KC_PSCR",
            "KC_TRNS",
            "KC_TRNS",
            "KC_TRNS",
            "KC_TRNS",
            "KC_TRNS",
            "KC_TRNS",
            "KC_TRNS",
            "KC_TRNS",
            "KC_TRNS",
            "KC_TRNS",
            "KC_TRNS",
            "KC_TRNS",
            "KC_TRNS",
            "KC_TRNS",
            "KC_TRNS",
            "KC_TRNS",
            "KC_TRNS",
            "KC_TRNS",
            "KC_TRNS",
            "KC_TRNS"
        ],
        [
            "KC_TRNS",
            "KC_EXLM",
            "KC_AT",
            "KC_LCBR",
            "KC_RCBR",
            "KC_AMPR",
            "KC_PMNS",
            "KC_7",
            "KC_8",
            "KC_9",
            "KC_PSLS",
            "KC_TRNS",
            "KC_TRNS",
            "KC_HASH",
            "KC_DLR",
            "KC_LPRN",
            "KC_RPRN",
            "KC_ASTR",
            "KC_PPLS",
            "KC_4",
            "KC_5",
            "KC_6",
            "KC_PAST",
            "KC_TRNS",
            "KC_TRNS",
            "KC_PERC",
            "KC_CIRC",
            "KC_LBRC",
            "KC_RBRC",
            "KC_EQL",
            "KC_ESC",
            "KC_TRNS",
            "KC_TRNS",
            "KC_TRNS",
            "KC_PEQL",
            "KC_1",
            "KC_2",
            "KC_3",
            "KC_ENT",
            "KC_TRNS",
            "KC_TRNS",
            "KC_TRNS",
            "KC_TRNS",
            "KC_TRNS",
            "KC_TRNS",
            "KC_TRNS",
            "KC_0",
            "KC_0",
            "KC_DEL",
            "KC_DEL",
            "KC_TRNS",
            "KC_TRNS",
            "KC_TRNS",
            "KC_TRNS",
            "KC_TRNS",
            "KC_TRNS",
            "KC_TRNS",
            "KC_TRNS",
            "KC_TRNS",
            "KC_TRNS"
        ],
        [
            "KC_TRNS",
            "KC_F9",
            "KC_F10",
            "KC_F11",
            "KC_F12",
            "KC_TRNS",
            "KC_TRNS",
            "KC_TRNS",
            "KC_TRNS",
            "KC_TRNS",
            "KC_TRNS",
            "KC_TRNS",
            "KC_TRNS",
            "KC_F5",
            "KC_F6",
            "KC_F7",
            "KC_F8",
            "KC_TRNS",
            "KC_TRNS",
            "KC_TRNS",
            "KC_TRNS",
            "KC_TRNS",
            "KC_TRNS",
            "KC_TRNS",
            "KC_TRNS",
            "KC_F1",
            "KC_F2",
            "KC_F3",
            "KC_F4",
            "KC_TRNS",
            "KC_TRNS",
            "KC_TRNS",
            "KC_TRNS",
            "KC_TRNS",
            "KC_TRNS",
            "KC_TRNS",
            "KC_TRNS",
            "KC_TRNS",
            "KC_TRNS",
            "KC_TRNS",
            "KC_TRNS",
            "KC_TRNS",
            "KC_TRNS",
            "KC_TRNS",
            "KC_TRNS",
            "KC_TRNS",
            "KC_TRNS",
            "KC_TRNS",
            "KC_TRNS",
            "KC_TRNS",
            "KC_TRNS",
            "KC_TRNS",
            "KC_TRNS",
            "KC_TRNS",
            "KC_TRNS",
            "KC_TRNS",
            "KC_TRNS",
            "KC_TRNS",
            "KC_TRNS",
            "KC_TRNS"
        ],
        [
            "KC_TRNS",
            "KC_TRNS",
            "KC_TRNS",
            "KC_TRNS",
            "KC_TRNS",
            "KC_TRNS",
            "KC_TRNS",
            "KC_TRNS",
            "KC_TRNS",
            "KC_TRNS",
            "KC_TRNS",
            "KC_TRNS",
            "KC_TRNS",
            "KC_TRNS",
            "KC_TRNS",
            "KC_TRNS",
            "KC_TRNS",
            "KC_TRNS",
            "RGB_TOG",
            "RGB_SAI",
            "RGB_HUI",
            "RGB_VAI",
            "RGB_MOD",
            "KC_TRNS",
            "KC_TRNS",
            "KC_TRNS",
            "KC_TRNS",
            "KC_TRNS",
            "KC_TRNS",
            "KC_TRNS",
            "KC_TRNS",
            "KC_TRNS",
            "KC_TRNS",
            "KC_TRNS",
            "KC_TRNS",
            "RGB_SAD",
            "RGB_HUD",
            "RGB_VAD",
            "RGB_RMOD",
            "KC_TRNS",
            "KC_TRNS",
            "KC_TRNS",
            "KC_TRNS",
            "KC_TRNS",
            "KC_TRNS",
            "KC_TRNS",
            "KC_TRNS",
            "KC_TRNS",
            "KC_TRNS",
            "KC_TRNS",
            "KC_TRNS",
            "KC_TRNS",
            "KC_TRNS",
            "KC_TRNS",
            "KC_TRNS",
            "KC_TRNS",
            "KC_TRNS",
            "KC_TRNS",
            "KC_TRNS",
            "KC_TRNS"
        ]
    ]
}

